10
10
##########
##########
###p...###
###..b.###
###.#b####
###._.####
##.._b####
##.._.####
##########
##########