10
10
##########
#_b_######
#......###
###.#..###
###..b.###
###.b._###
#..pb#_###
#.b..._###
##########
##########