10
10
##########
##.._#####
##.b...###
###.#..###
#..p.b.###
#.#..b.__#
#....#.#.#
###.b..._#
##########
##########