10
10
##########
##########
####_#####
####.#####
####b#####
####.#####
####.#####
####p#####
##########
##########