10
10
##########
##########
#....._###
#..#.b.###
##..b.._##
###b.b#.##
###..bp.##
###___.###
##########
##########