10
10
##########
##########
##.b.._###
##.....###
###.#..###
###..b.__#
###p.b#b.#
###.b.__##
##########
##########