10
10
##########
######...#
###_...p.#
###.#b.###
###...b###
###b...###
###.b#_###
###..._###
###_.#####
##########