10
10
##########
##########
##########
####.p.###
####b..###
####...###
####.#####
####.#####
####_#####
##########
