10
10
##########
##########
##########
####...###
####...###
####...###
####b#####
####p#####
####_#####
##########
