10
10
##########
##########
###....###
###..b.###
###..#.###
###_...###
####b#####
####p#####
####_#####
##########
