10
10
##########
##########
###_...###
###_#b.###
###.b..###
###....###
###.b#.###
###..p.###
#####._###
##########