10
10
##########
##########
####...###
####.#.###
###p...###
###.#.__##
###.bb#.##
#####...##
##########
##########